11111111111111111111111111111111
10000000000000000000000000100001
10000000000000000000000000100001
10000000111111000000000000100001
10000000100001000000000000100001
10000000111111C00000000000100001
1000000000C000000000000000100001
100000000000000000C0000000100001
10000000000000000000000000100001
10000110000000000000000000100001
10000000000000000000000000100001
10000110000000000000000000100001
10000000000000000000000000100001
10000110000000000000000000100001
10000110000000000000000000100001
10000110000P000000CCC01111100001
100000000000000000CEC01000100001
100000000000000000CCC01000100001
11111111111111111111111111111111