111111111111111111111111111111111
100000000000000000000000001000011
100000000000000000000000001000011
100000001111110000000000001000011
100000001000010000000000001000011
10000000111111C000000000001000011
1000000000C0000000000000001000011
100000000000000000C00000001000011
100000000000000000000000001000011
100001100000000000000000001000011
100000000000000000000000001000011
100001100000000000000000001000011
100000000000000000000000001000011
100001100000000000000000001000011
10000110000P000000CCC011111000011
100000000000000000CEC010001000011
100000000000000000CCC010001000011
111111111111111111111111111111111