111111111111111111111111111
100000000000000000000000001
100000110000001111000000001
100001010000010000100000001
100010010000100000010000001
100100010000100000010000001
101111111110000011100000001
100000010000000100000000001
100000010000001000000000001
100000010000011111110000001
100000000000000000000000001
100000000000000000000000001
10000000000PCE0000000000001
111111111111111111111111111